11111111111
1C100P000C1
1C100000101
10100E00101
11111111111