1111111111111111111111111111111111
10000P0000000000000CCCCCCCCCCCCCC1
1011100001111000111100011100000001
1000100000CE10000C0100000100000001
10001000011110001111CCCCC100000001
100010000C001000C00100000100000001
1001110001111000111100000100000001
1000000000000000X00000000000000001
100000C000000C000C00CC0CCCCCCCCC01
1111111111111111111111111111111111